63
43
111111111111111111111111111110000011111111111111111111111111111
111111111111111111111111111110000011111111111111111111111111111
111111111111111111111111111110000011111111111111111111111111111
112112111111111111100110011110000011110011011000111000110110011
112222211111111111000000011110000011110000000000000000000000001
112222222222222222000000000000000000000000000000000000000000011
222222222222222222000000000000000000000000000000000000000000000
111222222222222222000001111000000000111100000000000000000000000
111222222111111111110111111000000000111100000000000000000000000
111222222111111111110111111000000000111100000000000000000000011
111222222111111111110111111110000011111111111111111110000000111
111112111111111000000011111110000011111111111111111110000001111
111112111111111000000011111110000011111111111111111110000011111
111112111111111111000011111110000011111111111111111110000111111
111000000011111111111111111110000000001111111000000000000111111
111000000011111111111111111110000000001111111000000000000111111
111000000001111111111111111110000000000111110000000000000111111
111000000001111111111111110000000000000111100000000000000111111
111000000001111111111111110000000000000111100000000000000111111
111000000001111111111111110000000000000111100000000000000111111
111000000001111111111111100000000011111111111111000000000111111
111000000001111111111111100000000011111111111111000000000111111
111000000001111111111111100000000011111111111111000000000111111
111000000011111111100000000000000011111111111111000000000111111
111111110111111111100000000000000011111111111111000000000001011
111111111111111111100000000000000011122222222211000000000000011
111111111111111111100000000000000012222222222211000000000000011
111111111111111111100000000000000012222222222211000000000000011
111111111111111111111100000000000012222122122211111100000000001
110000001111111000111100000000000012222122111111111100000000001
110000001111111110111100000000000011111122111111111100000000001
110111111111111110111111111100000011111122111111111100001111011
110111111111111110111111111100000000002222221111111000001111011
110111111111111110111111111100000000002222221111111000001111011
110111111111111110111111111110000000000000001111111000001111111
110000001111111110000000011110000000000000000000000000000000111
110000011111111111000000011110000000000000000000000000000000111
110000000000000000000000011110000000000000011111111110000000011
110000000000000000000000000000000000000000011111111110000000011
110000000000000000000000000000000000000000011111111110000000011
111111111111111111111111111111111111111111111111111111111111111
111111111111111111111111111111111111111111111111111111111111111
111111111111111111111111111111111111111111111111111111111111111

